2------------10--------10000000001-----
111111-11111-11111-111-11111111101-1-11
-------10001---1---1-1-----1000001-1---
-1111111110111-1-111-11111-1011111-111-
00000100000001---1---------100000----1-
111101110111111111-1111111-11111111111-
000100010000000001-1000001-------------
010111011111111101-101110111111111-1111
010000010001000101010100010001000--1---
0111111101010101010101010101010111-1-1-
0100000101000101000101010001010001---1-
0101110101111101111101011111011111-111-
0100010001000000000001000001000000013--
