2------------1000------1000000000100000
111111011111-11111-111-1111111110101011
000000010001---1---101-----100000101000
01111111110111-1-111-11111-101111101110
00000100000001---1---------100000000010
111101110111111111-1111111-111111111110
000100010000000001-1000001-----------00
010111011111111101-101110111111111-1111
010000010001000101-101000100010000-1---
011111110101010101-101010101010111-1-1-
0100000101000101000101010001010001---1-
0101110101111101111101011111011111-111-
010001000100000000000100000100-----13--
