2------------1---------1000000000100--0
111111-11111-11111-111-1111111110101-11
00000--10001---1---101-----100000101---
01111111110111-1-111011111-10111110111-
00000100000001---100000000-10000000001-
11110111011111111101111111-11111111111-
00010001000000000101000001-------------
0101110111111111010101110111111111-1111
010000010001000101010100010001000--1---
0111111101010101010101010101010111-1-1-
0100000101000101000101010001010001---1-
0101110101111101111101011111011111-111-
0100010001000000000001000001000000013--
